. # # . . . # . . . . . . # . . # # # . . # # # . . . . . . . # . . # . # . # . . . . . . . . . . . 
. . # # # . . . . # # . . # . # . . # # # . # . . # # . . # . . # # . . . . . # . . . . . . . . # . 
# . # . . . . # . . . # # . # # . # . . . . # # # . . # . # . . # . . . . . . . # # . . . . . # # . 
. . . . . # . . # # . . . . . . . . . # # # . . . . . . # . . # # . . . # # . . . . # # # . . . . . 
. . # . # # # . . . . . . . . . . . # . . . . . . . . # . . # . . # . . . . . . # . . . . . . . . . 
# # . . . # . . . . # . # . . . . . . # . . # . . . # . # . . . # . # . . # # . # . . # # . # # . . 
. . . # . # . . . . # . # . # . . # # # # # . # . # # # . . # . . # # . # . . . . # . . # . . . # . 
. . . . . . # . . . # . . # # . . # . . . . . # . . . . # # . . # # . . . . . . . . . # . . . # # . 
. . # . . . . . # . # . . # . . . # . . . # # . . . . . . . # . . . . . . . . # . # . . # # # . . . 
. . . . . . . # . . . . . . . . . . # # # . . # # . # . # . . . # # . # . . . . . # . . . . # . # . 
. # . . . . # . . . . . . . . . . . . . . # . . # # # . # . . . . # # . # # . # # # . . . . . . . . 
. . . . . # . . . # . . . . . . . . # . . . . . . # # . . # . . . # . . . . # . . # # . . . . . . . 
# . . . . . . . # . . . # # # # # # . . . # # . # . . . # . # . # . . . . . . # # . . . . . . . . # 
. # . . . . . . # . . # . . . # . . . # . # . . # . . . . # . . . . . . . . . . # . # . . # . # . . 
. . . . # . # . # # # # # . . . . . # . # . # # # . . # . # # . . . . . . # . . # . . . . . . . . # 
# . # . # . . . # . . . # . . . # # . # . . . . . # # # # . . . # . # . . . # # . # . # . . # # . # 
. . # . . . . . . . # . . # . # # . . . # . . . # . . . . . # . . # # . # . # . . . . . . . # # . . 
# # . . # . . . . . . . . # . . # . . . . . . . . . . . # . . . # . . # . . # . . # . . . . . # . # 
. # . . # . . # . . . # . . . # # # . . . # . . # # # # # . # . . # . . . . . . . . . . . . # . # # 
. # . . # . . . . . . # # . # . # . . # # # . . # . . . # . . . . # . . . # # . . # # # # . . . # . 
. # . . . . . . . . . . # . . # # . . # . # # . # . # . # . . . . . . # . . . . . . . . # # # # . # 
. . . # . . . . . . . . . . . . # # . . . . . . . . . # . . . . . . . . . . # . . # # . # . . # . . 
. # # # . . . . # # . . . . . . . . # . . # . . # . . . . # . . . # # . # # . . . . . . . . # . # . 
# . # . . . . . . # # # # . . . . . . . . . . . . # . . . # . . . . . . . . . . . # . # . . # . . # 
. # . . # # . . . . # . . . . # # . . . . # . # # . . . . . . . # . # . . . # . . . . . . . # . . . 
# # . . # # # . # # . . . # # . . . . # # . . . . # . . . # . . . # . # . . # . . # . . # . . # . # 
. . . . . # . . . . . . . . . . . . . . # . # # # . . # . . # # # # # . . # # . . . # # . . . # . . 
. . # . # . . # . . # # . . . . . . . . . . . # . . . . . . . . # . # . . # . . . . . . . # # # . . 
. . . # . . . . # . # . . . # # . . . . . # # # . . . . . # . . . . . . . . # . . # . . . . . # . . 
. # # . . . . . # # . . . . # . . . . . . # # . # . . . . . . . . # . . . . # . . . . . . # . . . . 
# # . # . . . . # . . . . . # # . . . . # . . . . # . . # . . . . . # . . . # # . . # . # . # . # # 
. . . # . # . # . # . . # . . . . . . . # # . . # . . . . . . . . . # . . . . . # . # . . . . . . . 
. # # . . . . . . . . # # . . # . . . . # # . # . # . . . . # # # . # . . . . # . . . # . . . . . . 
. . # . . # . . . . . . . . . # . . . . . . . . . . . . # . # . . . . # # # # . . . . . # . # . # . 
# # # # . . . . . . # . . # . # . . . # . . . # . . . . # . . . # # . . # . # . . . . # . . . . . . 
# # . . # # . # # . . . # . . . # . . # . . . # # . . . . . # # . . # # . # . # . # . . . . . # . . 
. # . . . # . . . # . . . . # # . . # . . . # . . . # # . . . # # . . # . . . # . . . . # . . . # # 
. . . # # . # . # . . # . # . . . # . . . . . . . . . . . . . # # . . . . # . # # . . . . . . . # . 
. . . # . . . . . . . . . . . # . # . # . . . # . # . . . . . . # # # . . . . . . # # . . # # . . # 
# # . . # # # . . . # . . # # . # . . . # # . . . . . . # # . . . . . . . . . . . # . # # . . . . . 
. . . . . . # . . . . . # . # . . . # # . # . . . . . . # . . . . . . # . . . . # . . . . # . . # # 
# . # . . # . . # . # . . . . # . . . # . . . . . # . . . # . # . . . . . . # . . . # . . . . # . . 
. . . # # # . . . . . . . . . # . # . . . # . . # . . # . # . # . # . . . # . # # # . . . . . . . . 
. . . . # . . # . . . . . # . . # # . . # . # # . . . . # . . # . # . . . . . . . # . . . # . . . # 
# . . . . . # . . # # . . . . . . # # . . . . # . . . . # . . . # . . . . # # # # . . . . . . . # . 
. # . # # . . . # . . . . # # . # . . . # . # . . . . . # . . . # # # # . . . . # . . . . . . . # # 
# # . . . # . . . # . . # # . . . . . . . . . # . . # # . # # . # . . . # . # . # # # . . . . . . . 
# . # . # . . . # . # . # # . . . . . . . . . . . . . # # # . . . . # . . . . . . . # . # . . . . . 
. . . . . # . . . . . . . . . . . . . . . . # . # # # . # # # . # # # . # # . # . . # . . # # . # # 
. . . . . . . . . # # . # . . . . . . . . . . # # . . . . # . . # . . . . . # . . . . . . . . # . # 