. . . . # . . . . # # # . . . . # # # . . . # # . . # . . . # . . . . . . . . . 
. . . . . # . . # . # # . . # # # . . . . . . . . . # . . # . . . # . . . # . . 
# # . . . # . # . . # # . # # . . . . . . # # . . . # # # # . . . . . . . . . . 
. # . . . . . . . . . # # . # # . . # . . # . . . . . # . # . . . . . . . . . . 
. . . . # # . . . . . # . # # . . . . . . # . . . . . # . . . # # . . . . . . . 
. # . . # # # . . . . . . # . # . . . . . # # . . # . # . . . . # . . . # . . # 
. . . . . # . . # . . # . . # . . . # . # # # . # . # . . . . . . . . . # . . . 
. . . . . . . # . . # . # . . . . # . . # # # . # . . # . # . # . . . . . . . . 
. # # . # . # . # . . # . . . # # . # . # . . . . # . # . . . . . . . # . . . . 
. . . . . . . . # . . . . . . . . . # # . . . . . . # . # . . # . . # # . # . . 
. . . . . # # . # # . . # . # . . # . . . . . . . . . . . . . . # # . # # . . . 
. . . . # . . . # . . # . . . . . . . . . . . . . . . # . . . # . . . . . # . . 
. . . # . # . # . . . # . # # . . # . # . . # # . . # # . . . . . . . . . . # . 
. # . # . . # # . . . . . . # . . . . # . . . # . # . . . . . . . . # . # . . . 
. . # . . . # # . # . . # # # . . . # . # # . . # . . # # . . . . . . . # . . . 
# . . # . . # # # . . . . # # . . . # . . . . . . . . . . . . . . . . . . . . # 
. . . # . . . # . # # . # . . . . . . . . . # # . # . # . . # . . . . . # . . . 
# . . . . . . . . . . # # # . . . . . . . . . . # . . . . # . . . # . # # . . . 
# . . . # . . . . # # . . . . # . . # . . . . # . . . . . # . . . . . . . # # . 
. . . . . # . . . . # # . . . . . . . # # . . # . . . # . # # . . # . . . . . . 
. . # # . . . # . # . . # # . . . # # # . . # # . . # . . . . . # . . . # . . . 
. . # . . # . . . . . . . . # # # # . . . # . . . . # # . . . . # # . . # . . . 
. # . # . . . . . # # . # . . . . . # . . . . # . . . . . . # # # . . # . # . . 
# # . . . # # . . # . . . . . . # . # . . . # . . . . . # . # . # . . . . # . . 
. . . # # . . . # . . . . # # . . # . . . . . . # # . . . # . # . . . . . # . . 
# . . . . . . # . # # # . . . . . . # . # . # # # . # . . . . . . # # . . . . . 
# # . . . . # . # . . # . . . . . . . # # . . # # . . # # # . # . . # # . . . # 
. . . # . . . . . . . # # . # . . . # . # # # . . # . . # # . . . . . . . . # . 
. # . . . . . # # . . # . . . . . . . . . # . # . # . . . . . # . . . . # . # . 
. . . # . . . # # . . . . . # . . . . # . . . # . . . # . . . # # . # # . # . . 
# . . . # . . . # . . . . . # # # . . . . # . # . . # . # . . . . # # . # . # # 
. . . . . # . . . . . . . # # . . . # # . . . . . . # . # . # # # . . . # . . # 
. # . # . # . . . # # . . . # . . # # # . . # # . . . . . . . # . . . # # . . . 
# # # . . . # . # . . # . # # . . . # . . # . # . # # . . . # . . # . . . . . # 
. # . . . . # . . . . . . . # # . # . . . . # # . . . # . . . . . . . . # . . # 
. . . # . # # . . . # . # # . . . . . . # . # # . . . . . . . . . . . . # . . . 
. . # . . . # . . # # . . # . . # # . . . . . # . . # . . # . # . . # # # # # # 
. . . . # . # # # # # . . . # # # . . . . . . # # . # . # . . . . # . . . # . . 
# . # # . # . . . . . . . . # # . . # # # . # . . # . . # . . . . # . . . # # # 
. . # . . . . . . . . . # . # # . # . . . . . . . # # . . . . . . . . # . . . . 
