. . # . # # . . # . . . . . # . . . . .
# . . # . . # . # # # . . . # # # . . .
# . # . . . . # # . . . . # # . . . . .
# # . # . . # # # . # . . # . . # . # .
. . . . # # . # . . . . # . . . . # . #
. . . . . . # # . . . . . . . . . . . .
. # # . . # . . # . . # . . . . . . . .
. . # . . # . . . . . . . # # # . . . #
. # . . . # # . . . . . . # # . # . . .
# # # . # . . . . . . . . . . # . . # #
. . # . . # . . . # . . . # # . . . . .
. . . . # . . . . . . # . . . . # # # .
# # . . # . # . . # . # . . . # . . . .
# # . . . . . . # # # # . . # . . . # #
. . . # . . . . . . # . . # . . . . . .
. # . . . . . # # . . . # . . # . . . #
. # . . . . . . . # . . . . . # . # . .
. # # . # . . . . . . # # . # # # # # .
. . . . . . . . # . . . . . . . . # . #
. . . . . # . . # . # # . # . . # . . .