#.........
#########.
..........
##....####
.......###
#####.....
........##