. . . . . . . 
# . . . . . . 
. . # . . . . 
. # . . # . . 
. # . . . . . 
. . . . . . . 
# . . # . # .